33 31 1450
011111111111111111111111111111110
100000000000000000000000000000001
103011111111111111111111111111101
101010000000000000000000000000101
101010111111111111111111111110101
101010100000000000000000000010101
101010101111111111111111111010101
101010101000000000000000001010101
101010101011111111111111101010101
101010101010000000000000101010101
101010101010111111111110101010101
101010101010100000000010101010101
101010101010101111111010101010101
101010101010101000001010101010101
101010101010101021101010101010101
101010101010101000101010101010101
101010101010101120101010101010101
101010101010100000101010101010101
101010101010111111101010101010101
101010101010000000001010101010101
101010101011111111111010101010101
101010101000000000000010101010101
101010101111111111111110101010101
101010100000000000000000101010101
101010111111111111111111101010101
101010000000000000000000001010101
101011111111111111111111111010101
101000000000000000000000000010101
101111111111111111111111111110301
100000000000000000000000000000001
011111111111111111111111111111110